Классы. Схема mvc

ШАБЛОНЫ.
1) layouts
- layout - теги <head> <footer> с содержанием, $headerContent, $mainContent переменные для вставки header и main.
- LandingPageHeader - хедер лэндинг страницы
- MainPageHeader - хедер страниц авторизированного пользователя

2) landingPage - содержание лэндинга со вставкой последних заданий

3) Tasks -
- NewTasksPage - список новых заданий с фильтрами и поиском
- CreateTaskPage - страница создания нового задания
- MyTasksPage - страница моих заданий
- ViewTaskPage - страница просмотра задания - инфа о задании, отклики, чат

4) Users
- UsersPage - страница списка исполнителей с фильтами
- ViewUsersPage - страница с инфой о пользователе - с отзывами

5) Account
- RegistrationPage - страница регистрации пользователя
- SettingPage - страница настроек пользователя
- SignUpModal - модальное окно входа на сайт

КОНТРОЛЛЕРЫ
- LandingController - работа с лэндингом
- LogoutController - выход пользователя
- SignUpController - регистрация пользователя
- TaskController - работа с заданиями
- UserController - работа с пользователями

MOДЕЛИ для таблиц базы данных

папка forms
- loginForm - форма авторизации
- signupForm - форма регистрации
- TaskForm - форма создания задания
- userForm - форма настроек аккаунты

вне папок:
- Categories  категории
- Cities города
- Favourites - избанные
- Message - сообщения
- Notifications - уведомления
- PortfolioPhoto - фото портфолио
- Response - отклики
- Task - задания
- User - пользователи
- UserCategory - пользователей с категориями
