Классы. Схема mvc

ШАБЛОНЫ.

1) Account
- SettingPage - страница настроек пользователя
- SignupPage - страница регистрации пользователя
- SignupFooter - футер страницы настроек пользователя

2) LandingPage - содержание лэндинга со вставкой последних заданий
- LandingPage
- SignUpModal - модальное окно входа на сайт

3) layouts
- LandingHeader - хедер лэндинг страницы
- layout - теги <head> <footer> с содержанием, $headerContent, $mainContent переменные для вставки header и main.
- MainHeader - хедер страниц авторизированного пользователя

3) Tasks -
- MyTasksPage - страница моих заданий
- TaskViewPage - страница просмотра задания - инфа о задании, отклики, чат
- TaskCreatePage - страница создания нового задания
- TaskCreateScript - подключение скрипта к странице создания нового задания
- TaskModal - модальное окно на странице задания
- TaskCreateScript - подключение скрипта к странице просмотра задания
- TasksPage - список новых заданий с фильтрами и поиском

4) Users
- UsersPage - страница списка исполнителей с фильтами
- UserPage - страница с инфой о пользователе - с отзывами

КОНТРОЛЛЕРЫ
- AccountController - работа аккаунтом пользователя
- LandingController - работа с лэндингом
- LogoutController - выход пользователя
- SignUpController - регистрация пользователя
- TaskController - работа с заданиями
- UserController - работа с пользователями
- MessageController - работа с сообщениями
- OpinionsController - работа с отзывами

MOДЕЛИ для таблиц базы данных

папка forms
- LoginForm - форма авторизации
- SignupForm - форма регистрации
- TaskForm - форма создания задания
- MessageForm - форма отправки сообщения
- ReviewForm - форма отправки отклика на задание
- UserForm - форма отправки отзыва

вне папок:
- Categories  категории
- Cities города
- Favourites - избанные
- FileTask - файлы заданий
- Message - сообщения
- Notifications - уведомления
- Opinions - отзывы
- PortfolioPhoto - фото портфолио
- Response - отклики
- Task - задания
- User - пользователи
- UserCategory - пользователей с категориями
